Archer=Archer
Baker=Boulanger
Banker=Banquier
Builder=Bâtisseur
Butcher=Boucher
Cook=Cuisinier
Designer=Décorateur
Digger=Terrassier
Driver=Conducteur
Druggist=Droguiste
Druid=Druide
Engineer=Ingénieur
Explorer=Explorateur
Farmer=Fermier
Fisherman=Pêcheur
Glass-blower=Verrier
Gunsmith=Armurier
Hunter=Chasseur
Knight=Chevalier
Lumberjack=Bûcheron
Miner=Mineur
Pour=Fondeur
Railwayman=Cheminot
Sailor=Marin
Shatterer=Destructeur
Shepherd=Berger
Social-worker=Assistant-social
Sorcerer=Sorcier
Stockbreeder=Eleveur
Tamer=Dresseur
Toolmaker=Outilleur
Trader=Marchand
Vegetable=Maraîcher
Warrior=Guerrier
Wizard=Enchanteur

+job : +xp xp=+job : +xp xp
+player is now +job=+player est maintenant +job
+player job +job removed=+player n'est plus +job
Only players can /jobxp=Seuls les joueurs peuvent /jobxp
Reloaded jobs configuration=Configuration des métiers rechargée
Unknown job +job=Métier inconnu +job
You need RealStats plugin to make this work=Le plugin RealStats est nécessaire
